1111111
111ECP1
1110C01
111UC01
1110C01
1111111