1111111111111111111111111111111111
100000U00000000C00000C000000000001
10100101001000001010010000000101E1
10100100101010100010010000000101C1
1P0000000C00C0000000000U00000001U1
1111111111111111111111111111111111