1111111111111111111111111111111111
100000C00000000C00000C0000000000C1
10100101001000001010010000000101E1
10100100101010100010010000000101C1
1P0000000C00C0000000000C00000001C1
1111111111111111111111111111111111