1111111111111111111111111111111111
1E0000U00000000C00000C000000000001
1010010100100000101001000000010101
1010010010101010001001000000010101
1P0000000C00C0000000000U00000000C1
1111111111111111111111111111111111