1111111111111111111111111111111111
1E0001U00000000C00000C000000000001
1111111111111111111111111111111111