1111111111111111111111111111111111
1E000000U000000C00000C0000000000P1
100000000000000C00000C000000000001
1111111111111111111111111111111111